25,13
4,0
24,10
XXXX0XXXXXXXXXXXXXXXXXXXX
X0000000XXXXXXXXXXXXX0XXX
X0XXX0X00XX000000XXX00XXX
X00XX0XX0000XXXX00XX0XX0X
XX0XX0XXXX0XXXXXX0000XX0X
X00XX000XX0000XXXXX0XX00X
X0XXXXX0XXXXX000XX00X00XX
X0000XX0000000XXXX0XX0XXX
XXXXXX00XXXXXXXX000XX0XXX
XXXXXX0XXX0000000XXXX00XX
XX00000XX00XXX0XXXXXXX000
X00XXXXXXXXXXX000000000XX
XXXXXXXXXXXXXXXXXXXXXXXXX
