XXXX0XXXXXXXXXXXXXXXXXXXX
X0000000XXXXXXXXXXXXX0XXX
X0XXX0X00XX000000XXX00XXX
X00XX0XX0000XXXX00XX0XX0X
XX0XX0XXXX0XXXXXX0000XX0X

